重+100%=Heavy+100%
力+100%=Power+100%
足+100%=Foot+100%
葉のベッド=Leaf bed
鉄の棍棒=Iron club
相手を殴って気絶させるための武器\n\n<color\=#33FF99>気絶10</color>=Weapons to beat and stun the opponent\n\n<color\=#33FF99>Stunning 10</color>
旗=Flag
ボディーフック=Body hook
茂み=Brush
枝=Branch
シカ=Deer

ナコル=Nakol
スタンド松明=Standing torch
肉の作業台=Meat workbench
雨水収集器=Rainwater collection device
鉄の檻=Iron cage
石の家=Stone house

壁尻（植物）=Wall butt (Plant)
のんびり=Relaxing
鉄の剣=Iron sword
\n\n<color\=#33FF99>攻撃力12</color>=\n\n<color\=#33FF99>Attack power 12</color>
赤いビキニ（下）=Red bikini (Bottom)
赤いビキニ（上）=Red bikini (Top)
貝殻で作られた乳隠し=Seashell bikini
岩を砕くことが出来るツール\n\n<color\=#33FF99>攻撃力1</color>=A tool that can crush the rocks\n\n<color\=#33FF99>Attack power 1</color>
原住民スカート=Native skirt
焼いた肉（料理）=Grilled Meat (Dish)
角の首飾り=Claw Necklace
焼いた肉\n\n<color\=#33FF99>食料30</color>\n\n<color\=#00fa9a>料理効果（襲撃時）</color>=Grilled Meat\n\n<color\=#33FF99>Food 30</color>\n\n<color\=#00fa9a>Cooking Effect (During attack)</color>
絞首台=Square
サンダル=Sandals
処刑=Execution
Tシャツ=T-shirt
シャワー=Shower
人を監禁するための檻\n人を監禁して食べ物を入れておくと\n餌付け出来る（収容可能数3）=You can imprison and convert people by feeding them. (3)
人を監禁するための檻\n人を監禁して食べ物を入れておくと\n餌付け出来る（収容可能数1）=You can imprison and convert people by feeding them. (1)
木の針床=Wooden needlebed
木の作業台=Wooden workbench
魔寄せの飾り=Magical decoration
装備していると襲撃で狙われるようになる=If you are equipped, you will be targeted by an attack
惚れ薬=Love Potion
葉っぱのダミー人形=Leaf dummy dolls
石のプランター=Stone planter
トメ=Tome
媚薬=Aphrodisiac
植物の作業台=Plant workbench
運搬中の原住民（女の子）=Carrying Native (Girl)
運搬中の原住民（女）=Carrying Native (Female)


メスのニワトリを配置すると、卵を産ませることができる\n（収容可能数3）=If you place a female chicken, you can lay eggs (3)
皮=Leather
ツル=Vine
蔓の服（足）=Vine clothes (Legs)
黄色い花=Yellow flower
花のライト（青）=Flower light (Blue)
樹液=Sap
アジサイ（青）=Hydrangea (Blue)
フレンド=Friend
木の器（きれいな水）=Wooden Bowl (Clean water)
布=Cloth
木で作られた家=House made of wood
木の家=Wooden house
水上に設置できる照明=Lighting that can be installed on the water surface
女の子原住民の前掛け=Native naked apron
大自然の服（上）=Nature clothes (Top)
砂の作業台=Sand workbench
羊毛=Wool
鉄の作業台=Iron workbench
鉄インゴット=Iron Ingot
浴槽=Bathtub
鉄=Iron
ロープ=Rope
繊維を編み込んで強力にしたもの=Reinforced by weaving fibers
壁尻（木）=Wall butt (Wood)
壁尻（石）=Wall butt (Stone)
葉=Leaf
繊維=Fiber
一つ設置する毎に襲撃者の人数が10増える=Each time you install it, the number of attackers increases by 10
虫取り網=Insect mesh
ダイヤモンド=Diamond
ジャイアント=Giant
砂=Sand
木材=Wood
創造力を掻き立てる作業台=Workbench that stirs creativity
ガラス=Glass
カーテン（ブルー）=Curtain (Blue)
花のトーテム=Flower totem
石=Stone
溶鉱炉=Blast Furnace

鉄のチェスト=Iron chest
男の作業台=Men's workbench
サボテン=Cactus
サボテン帽子=Cactus hat
クリスマスの作業台=Christmas workbench
ニンジン=Carrot

プレゼント袋=Present bag
トナカイの衣装（下）=Reindeer costume (Bottom)
着替えをするときの目隠しになる=It will be a blindfold when changing clothes
変異蓮=Mutant lotus
黒ベルト（下）=Black belt (Bottom)
骨=Bone
鬼の角=Demon horn
葉の前貼り小（上）=Leaf Pasties (Top)
対象のキャラクターはこのアイテムを装備できません=The target character cannot be equipped with this item
木のチェスト=Wooden chest
エレキール=Electric
鉄鍋=Iron pot
鉄でできた鍋=Pot made of iron
金インゴット=Gold ingot
奴隷の首枷=Slave shackles
\n\n<color\=#33FF99>攻撃力2</color>=\n\n<color\=#33FF99>Attack power 2</color>
鉄の斧=Iron ax
チェスト内のNPCは召喚できません=NPCs in the chest cannot be summoned
迷彩のハーフパンツ=Camouflage shorts
穀物等をすりつぶすことができる=You can crush cereals, etc.
石臼=Stone mortar
調理台=Cooking station
鉄のシャベル=Iron shovel
地面を掘り起こすツール\n\n\n<color\=#33FF99>攻撃力1</color>=Tools to dig up the ground\n\n\n<color\=#33FF99>Attack power 1</color>
ベリー=Berry
おいしそうな赤い実\n\n<color\=#33FF99>食料2</color>\n<color\=#33FF99>水分3</color>=Delicious red fruit\n\n<color\=#33FF99>Food 2</color>\n<color\=#33FF99>3 water</color>
コン=Congratulations
コンドム=Condom
断頭台=Guillotine
便器=Toilet bowl
小さな生き物を捕るのに使うツール。\n\n<color\=#33FF99>攻撃力1</color>=A tool used to catch small creatures.\n\n<color\=#33FF99>Attack power 1</color>
ふつうの木材=Normal wood
搾乳機=Milking machine
出産後のNPCを配置すると搾乳できる=After giving birth, you can milk the placed NPC
焚き火=Bonfire
食べ物を焼いたり出来る=You can boil or grill food
土=Soil
岩=Rock
アイテムを保管できる箱=Box that can store items
木=Wood
黒ベルト（上）=Black belt (Top)
10分間淫乱状態になる。\n重ねて使用すると時間が加算される。(100分まで)=Becomes horny for 10 minutes.\nTime is added when used repeatedly.\n(Up to 100 minutes)
妊娠確率が10倍になる=10x impregnation chance
妊娠促進アイテム=Pregnancy stimulating substance
全員の名前を表示/非表示=Display/hide everyone's name
ブラッドストーン=Bloodstone
チタニウム=Titanium
ラボのプラットフォーム=Lab platform
スクラップソード=Scrap sword
人造人間の結合に使用できる\n\n<color\=#33FF99>攻撃力6</color>=Can be used to join the Android\n\n<color\=#33FF99>Attack power 6</color>
鉄のピッケル=Iron pick
岩を砕くことが出来るツール\n石のピッケルより硬いものを砕ける\n\n<color\=#33FF99>攻撃力2</color>=Crush the rocks that can crush the rocks that are harder than the pikel of the stone\n\n<color\=#33FF99>Attack power 2</color>
鉱石を溶かすことができる=Can smelt ore
食料箱=Food box
対象のキャラクターはこのアイテムを使用できません=The target character cannot use this item
ニワトリ=Chicken
体=Body
敷石=Paved stone
木のベッド=Wooden bed
母乳（料理）=Breast milk (Dish)
石の壁=Stone wall
高級なベッド=Luxury bed
木の壁=Wooden wall
卵=Egg
鉄の柵=Iron fence
木で作られたバリケード=Wooden Barricade
尖らせた木を組んで作ったバリケード=Barricades made of sharpened wood
グレーのクッションソファ=Gray cushion sofa
出産所=Birthplace
木の器（汚い水）=Wooden bowl (Dirty water)
タミー=Tummy
牛乳=Milk
ピンクのクッション=Pink cushion
宝箱=Treasure Chest
葉の前貼り小（下）=Front leaf covering (Bottom)
牢=Prison
ハチミツ=Honey
薬草=Herb
水を持ち運べる皮の袋\n\n<color\=#33FF99>水分40</color>\n<color\=#33FF99>食中毒-10</color>\n\n<color\=#FF0033>攻撃力0</color>=Waterskin made from animal leather.\n\n<color\=#33FF99>Moisture 40</color>\n<color\=#33FF99>Food poisoning -10</color>\n\n<color\=#FF0033>Attack power 0</color>
皮袋（きれいな水）=Waterskin (Clean water)
皮袋（汚い水）=Waterskin (Dirty water)
赤キノコ=Red mushroom
ピーマン=Green pepper
小動物を飼育するための檻\n捕獲した動物とエサを入れておくと\n餌付け出来る（収容可能数2）=A cage for keeping small animals.\nPlace captured animals and feed inside.\nYou can breed them.\n(Can accommodate up to 2)
成長薬=Growth drug
飲むと成長値が上昇する\n成長値が18になると大人の姿になる\n（女の子原住民専用）=When consumed, the age increases.\nWhen the age value reaches 18, it transforms into an adult form.\n(Exclusive for female natives)
指ドッグ(Dish)=Finger dog (Dish)
オオカミ=Wolf
ごく普通の粘土=Common clay
ヤシの実=Coconut
ふつうの管=Ordinary cock
焼いた小さな管=Roasted small cock
目玉ジュース(Dish)=Eye-drop juice (Dish)
串焼き(Dish)=Skewers (Dish)
ダイヤのピッケル=Diamond pick
岩を砕くことが出来るツール\n鉄のピッケルより硬いものを砕ける\n\n<color\=#33FF99>Attack4</color>=A tool that can crush rocks harder than an iron pickaxe.\n\n<color\=#33FF99>Attack4</color>
焼いた小さい肉=Grilled small meat
焼いた小さい肉(Dish)=Grilled Small Meat (Dish)
食べ物が腐ったもの=Rotten food
レイプおじさん=Uncle Rape.
鉱山（南）=Mine (South)
コウモリ=Bat
アングラー=Angler
三角ハット=Triangular hat
Got 男の作業台レシピ!=Got Oji-san's workbench recipe!
クモ=Spider
水槽（大）=Water tank (Large)
伐採の仕事をする場所=Where we do our logging work.
伐採場=Logging Camp
捕獲したニワトリのメス=Captured female chickens
ニワトリ（メス）=Chicken (Female)
焼いた肉=Roasted meat
焼いた小さい肉（料理）=Grilled Small Meat (Dish)
ガラスケース（大）=Glass case (Large)
フライドポテト（料理）=French fries (Dish)
マッシュポテト（料理）=Mashed Potato (Dish)
干し芋（料理）=Dried sweet potato (Dish)
ダイヤの斧=Diamond Axe
皿=Dish
捕獲したニワトリのオス=Male captive chickens
捕獲したウサギ=Captured rabbits
石の斧が壊れた=The stone axe broke.
腐った食べ物=Rotten food
ネックリング=Neck ring
串焼き（料理）=Skewers (Cuisine)
ジャガイモの串焼き(Dish)=Grilled Potato Skewers (Dish)
鉄の針床=Iron needlebed
ダイヤのワンド=Diamond Wand
ダイヤの短剣=Diamond Dagger
鉄で作られたバリケード=Barricades made of iron
鉄の壁=Iron wall
寿司(Dish)=Sushi (Dish)
ガラスケース=Glass case
小さな生き物を飾ることができる=Can be decorated with small creatures.
トレーダー=Trader
紐の水着（下）=String swimsuit (Bottom)
草花の水着（上）=Flower swimwear (Top)
露出水着（上）=Exposed swimsuit (Top)
花火（赤）=Fireworks (Red)
水鉄砲=Water gun
ビーチマット=Beach mat
魚油=Fish oil
バブルマシーン=Bubble machine
姉御原住民=Sister
アジサイ（赤）=Hydrangea (Red)
花のライト（赤）=Flower light (Red)
ネック=Ostrich
丈夫な木材=Durable wood
採掘場=Mining ground
採掘の仕事をする場所=Where to work for mining
ハチの巣=Beehive
ふつうの木炭=Ordinary charcoal
金=Money
木の盾=Wooden shield
ティアラ=Tiara
鉄の盾=Iron shield
ニーハイソックス（白）=Knee High Socks (White)
食料を入れておくと\n範囲内の味方に食料を配ることができる=If you put in food, you can distribute it to your allies within the range
地面にさして置ける松明=Firework that can be placed on the ground
斧を装備していません=Not equipped with an axe
木からとれる樹液=Sap taken from trees
バター=Butter
森の敷物=Forest rug
翼の作業台=Wing workbench
可愛いテーブル=Cute table
鉄の矢=Iron arrow
ピンクのカーペット=Pink carpet
ヒツジ=Sheep
タクミのメモがいろいろ書いてあるノート\nクラフトできるアイテムが増える=Book filled with Takumi's notes.\nMore items can be crafted.
タクミのノート=Takumi's notebook
ベアトラップ=Bear trap
強化虫取り網=Enhanced insect mesh
鉄のダミー人形=Iron dummy doll
鉄のテーブル=Iron table
修理キット=Repair kit
ハニワ=Haniwa
飼育場=Breeding ground
動物を放し飼いにする=Release animals
羽根=Feathers
養鶏場=Poultry farm
蜘蛛の巣=Spiderweb
蜘蛛の作業台=Spider's workbench
葉っぱで作った簡易的な家=A simple hut made of leaves
葉の家=Leaf hut
木のシャベル=Wood shovel
イエローベレー=Yellow beret
白キノコ=White mushroom
釘バット=Nail bat
石の斧=Stone axe
石のピッケル=Stone Pick
木箱=Wooden box
養豚場=Pig farm
蜘蛛の皮=Spider skin
様々な場所に設置できる照明=Lighting that can be installed in various places
蜘蛛のランタン=Spider lantern
蜘蛛の皮シャツ=Spiderskin shirt
蜘蛛の皮スカート=Spiderskin skirt
血肉収集器=Hematic Hoarder
血肉=Viscera
蜘蛛帽子=Spider hat
蜘蛛の盾=Spider shield
ブタ=Pig
細いけれどそこそこ丈夫=Thin but moderately durable
デビルマスク=Devil Mask
スニーカー=Sneakers
収穫箱=Harvest box
魚捕り=Catching fish
葉の敷物=Leaf rug
大自然の服（下）=Nature clothes (Bottom)
起動すると周囲の人体パーツを収集する\n起動するために10%の体力を消費する必要がある=Collects surrounding human body parts when activated\nRequires 10% of physical energy to activate
魔法の羽根=Magical feathers
鉄の棍棒が壊れた=The Iron club broken
井戸=Well
範囲内の味方に水を配ることができる\n時間経過で中身が満たされる=The contents are refilled over time to distribute water to allies within the range
フニッカーズ=Funickers
チョウ=Butterfly
装備していると妊娠しない&させない=If equipped, you will not get pregnant.
避妊具=Contraception
石のプラットフォーム=Stone platform
ドングリ=Acorn
珊瑚（赤）=Coral (Red)
珊瑚（青）=Coral (Blue)
エレキールの筋肉=Electric muscles
葉っぱを敷いて作った簡易的なベッド=A simple bed made by laying leaves
プランターに植えると小麦が育つ=Wheat grows when planted in a planter
小麦の種=Wheat species
葉っぱを敷いて作った簡易的なテント=A simple tent made by laying leaves
葉のテント=Leaf tent
残骸=Wreckage
捕獲したシカ=Captured deer
上品な手を模ったキャンドル=Candle in the shape of an elegant hand
ハンドキャンドル=Hand candle
頭部をくり抜いて作られたキャンドル=Candle made by hollowing out the head
ヘッドキャンドル=Head candle
大きくならない=They don't grow.
管の鉢植え=Potted cocks
ブタの耳=Pig's ear
ふつうサイズの管=Normal size cock
小ぶりな管=Small cock
怒りの壺=Urn of wrath
呪いの壺=Curse jar
赤い煙=Red smoke
敵に位置を知らせる煙を発生させる\n一つ設置する毎に襲撃までの時間を30秒短縮=Informs the enemy where you generate smoke. Reduce the time to the attack by 30 seconds.
人体ラック=Human Body Rack
人体ラック（全身用）=Human body rack (Body)
人体ラック（横）=Human body rack (Horizontal)
人体ラック（置き）=Human body rack (Placing)
人体ラック（縦）=Human body rack (Vertical)
人体パーツを飾っておくためのラック=Rack for decorating human body parts
持ちきれないアイテムを落としました=I dropped items that I can't hold
葉のケース=Leaf case
ポーズ2=Pose 2
コーラ=Cola
ふつうの石=Ordinary stone
貝殻=Seashell
人魚=Mermaid
木炭=Charcoal
簡易的な浴槽=Simple bathtub
ジャガイモ=Potato
トマト=Tomato
母乳=Breast milk
赤薬草=Reddish grass
木の柵（小）=Wooden fence (Small)
きな粉=Kina powder
緑キノコ=Green mushroom
小麦粉=Flour
エビ=Shrimp
原住民シャツ=Native shirt
麻薬の効果がある\n\n<color\=#33FF99>食料1</color>=It has the effect of drugs\n\n<color\=#33FF99>Food 1</color>
鼻から吸い込むと深い眠りに落ちる=If you breathe it, you will fall into a deep sleep
狂気のオーブ 10=Orb of Madness 10
狂気のオーブ=Orb of Madness
闘士のオーブ=Orb of Valor
大地のオーブ=Orb of Earth
生命のオーブ=Orb of life
死者のオーブ=Orb of Death
鉱石で作られた針の床\n踏んだ敵に気絶ダメージを与える=Damage the stunning damage to the enemy who stepped on the needle made of ore
鉱石の針床=Ore Needlebed
鏡のような盾\nジャストガード時、敵に全ダメージを反射し、盾へのダメージも無くなる\nジャストガード以外ではガードされない\n\n<color\=#FF0033>Guard0</color>=Mirror-like shield\nReflects all damage to the enemy and eliminates damage to the shield when just guarded.\nIt cannot be guarded except by just guarding.\n\n<color\=#FF0033>Guard0</color>
鏡の盾=Mirror Shield
露出水着（下）=Exposed swimsuit (Bottom)
青い煙=Blue smoke
敵から見えにくくする煙を発生させる\n一つ設置する毎に襲撃までの時間を30秒延長=Generates smoke that makes it difficult to be seen by enemies\nExtends the time between attacks by 30 seconds for each one installed
青い花=Blue flower
赤身魚=Redfish
赤い花=Red flower
うんち=Poop
おじさん=Uncle
かやぶきの家=Thatched Roof House
ごく普通の土=Common soil
ごく普通の砂=Common sand
ブタの鼻=Pig nose
ブラッドソード=Blood sword
ブラッドナイフ=Blood knife
ビッグフット=Bigfoot
ビッグフット[ビッグフット]=Bigfoot[Bigfoot]
ヒョウ柄のビキニ（上）=Bikini with a leopard pattern (Top)
ヒョウ柄のビキニ（下）=Bikini with a leopard pattern (Bottom)
ヒル=Leech
ピンクのカーテン（大）=Pink Curtain (Large)
ピンクの鏡=Pink mirror
フィロッグ=Frog
あまりおいしそうではないが食べられる魚\n\n<color\=#33FF99>Food8</color>=Fish that doesn't look so tasty but is edible\n\n<color\=#33FF99>Food8</color>
男性器の小像=Small statue of male genitalia
いきり立つ男性器を模った小像\n遺跡を開く鍵になるらしい=Small statuette in the shape of a sprightly male genitalia\nIt is said to be the key to open the ruins.
いくつかの作物を育てる事ができる=You can grow some crops
この場を離れると失敗=Failed when you leave this place
これ以上使用できません=I can't use it anymore
そのまま食べられる魚の身\n\n<color\=#33FF99>Food10</color>=Fish meat that can be eaten as is\n\n<color\=#33FF99>Food10</color>
たくさんの作物を育てる事ができる=We can grow a lot of crops.
ただのサボテン=Just a cactus
ふつうの枝=Ordinary branches
ふつうの羽根=Normal feathers
ふつうの葉っぱ=Normal leaves
ふんどし=Fundoshi
ろうそく=Candle
イーター=Eater
ウェアウルフ=Werewolf
カエルに似た魚\nまずそう\n\n<color\=#33FF99>Food2</color>=Fish that look like frogs\nLooks bad.\n\n<color\=#33FF99>Food2</color>
カエル=Frog
オムレツ(Dish)=Omelet (Dish)
オムレツ=omelet
ウサギ 10=Rabbit 10
ウサギ=Rabbit
ウサギの服（上）=Rabbit Clothing (Top)
ウサギの服（下）=Rabbit Clothing (Bottom)
ウサギ帽=Rabbit hat
ウサギ服（足）=Rabbit clothes (Legs)
カニ=Crab
カニの甲羅=Crab shell
カーニバルマスク=Carnival mask
アイテムを保管できる箱\n様々な場所に設置できる=Boxes for storing items\nCan be placed in various locations
蜘蛛のチェスト=Spider Chest
蜘蛛の作業台の作り方がわかるレシピ=Recipe showing how to make a spider workbench.
蜘蛛の作業台レシピ=Spider Workbench Recipe
虹色の貝殻水着=Rainbow-shell swimsuit
魚を飾ることができる=Can be decorated with fish
高級豚肉=Luxury pork
高級牛肉（料理）=Luxury beef (Dish)
骨の盾=Bone shield
骨の松明=Bone torch
骨のランタン=Bone Lanterns
骨 8=Bone 8
飲むと劇的に若返る秘薬=Secret drug that dramatically rejuvenates when you drink
食パン=Plain bread
食べても腹の足しにならなそう\n\n<color\=#33FF99>Food2</color>=Even if you eat it, it doesn't seem to fill your stomach.\n\n<color\=#33FF99>Food2</color>
頭部を切り落とす処刑台=Platform for beheading.
鉄工することができる作業台=Workbench for crafting iron items.
鉄の剣が壊れた=The iron sword was broken
鉄のランタン=Iron Lanterns
鉄で作られた針の床\n踏んだ敵にダメージを与える=Iron needlebed\nDamages enemies who step on it.
鈴付きの首輪=Collar with a bell
釣りに使うツール。釣りには餌が必要\n\n<color\=#33FF99>攻撃力1</color>=A tool used for fishing.\nI need food for fishing\n\n<color\=#33FF99>Attack power 1</color>
金魚鉢=Goldfish bowl
金のランタン=Golden Lantern
辺りを照らすことが出来る=It can light up the area.
起動=Boot
追放者の穴=The Outcast's Hole
ヒツジ 25=Sheep 25
ブタ 25=Pig 25
シカ 25=Deer 25
ニワトリ（オス）=Chicken (Male)
ニワトリ（オス） 10=Chicken (Male) 10
ニワトリ（メス） 10=Chicken (Female) 10
ニンジンの種=Carrot seeds
ニンニクの種=Garlic seeds
\n\n<color\=#33FF99>攻撃力4</color>=\n\n<color\=#33FF99>Attack power 4</color>
\n\n<color\=#33FF99>攻撃力14</color>=\n\n<color\=#33FF99>Attack14</color>
\n\n<color\=#33FF99>攻撃力17</color>=\n\n<color\=#33FF99>Attack17</color>
\n\n<color\=#33FF99>攻撃力20</color>=\n\n<color\=#33FF99>Attack power 20</color>
\n\n<color\=#33FF99>攻撃力22</color>=\n\n<color\=#33FF99>Attack22</color>
\n\n<color\=#33FF99>攻撃力25</color>=\n\n<color\=#33FF99>Attack power 25</color>
\n\n<color\=#33FF99>攻撃力45</color>=\n\n<color\=#33FF99>Attack power 45</color>
避妊アイテム=contraceptive item
遺跡の燭台（青）=Candelabra of ruins (Blue)
遺跡の燭台（赤）=Candelabra of ruins (Red)
豚カツサンド（料理）=Pork cutlet sandwich (Dish)
謎の液体=Mystery liquid
設置型の照明=Fixed lighting
設置しておくと雨水を溜めることが出来る=If you install it, you can store rainwater
設置しておくと稀に魚を捕獲できる\n水場だけに設置可能=Rarely catches fish when installed\nCan be installed only in water bodies
設置しておくと稀に小動物を捕獲できる=Rarely captures small animals when installed.
設置しておくと稀に動物を捕獲できるが\nこの島のクマは捕まりそうにない=If you install it, you can rarely catch animals,\nbut the bears on this island\n are unlikely to be caught.
角マスク=Square mask
虫=insect
蔓の髪飾り=Vine hair ornaments
葉の水着（下）=Leaf swimwear (Bottom)
葉の水着（上）=Leaf swimwear (Top)
葉の前貼り=Pussy leaf
葉のパンツ=leaf pants
葉のアーチ=Leaf arch
草花の水着（下）=Flower swimsuit (Bottom)
若返り薬=Rejuvenation medicine
若返りの秘薬=Rejuvenation secret drug
若木=Sapling
花のライト（ピンク）=Flower light (Pink)
襲撃アイテム(仮)=Raid item (Provisional)
襲撃は起こらなかった=The attack did not occur
襲撃は終わった=The attack is over
キツネの尻尾=Fox's tail
キツネの耳=Fox ears
キツネの衣装（上）=Fox costume (Top)
キツネの衣装（下）=Fox costume (Bottom)
キャシーのストッキング=Cathy's stocking
キャベツ=Cabbage
キラ=Shit
クマ=Bear
ケージトラップ=Cage trap
ゲテモノ調理台=Native Cooking
コグモ=Spiderling
コスチュームの色を変えるための作業台=Workbench to change the color of the costume
ゴミくず=Garbage
ゴースト=Ghost
サイス=SCYTHE
サボテン服（上）=Cactus clothes (Top)
サメ=Shark
サンドワーム=Sandworm
シゴキ=Squid
シャツ=Shirt (Underwear)
ショップ=Shop
ショートスカート=Short skirt
ジャイアントの水着（緑縞）（上）=Giant swimsuit (Green striped) (Top)
ジャイアントハンド=Giant hand
スケルトン=Skeleton
スタンガン=Stun gun
スパイク=Spike
無線機=Radio
無線機を手に入れた！=I got a Radio!
タクミから預かった無線機=Radio taken from Takumi
男 has been spotted.=Boy has been spotted.
男=Boy
自分のインベントリに入っているアイテムと\n自分が装備しているアイテムを全て修理する=Repair all items in your inventory and all items you have
紙吹雪=Blizzard
紙袋=Paperbag
素朴な金魚=Goldfish
素朴な魚=Simple fish
紫の鉱石=Purple ore
綺麗な形の貝殻=Beautifully shaped shells
綺麗な石の首飾り=Beautiful stone necklace
緑のビキニ（上）=Green bikini (Top)
緑のビキニ（下）=Green bikini (Bottom)
眼球=Eyeball
眼球焼き(Dish)=Eyeballs Grilled (Dish)
睡眠粉=Sleeping powder
瞳=Pupil
瞳光沢=Glossy eyes
石で作られたバリケード=Barricades made of stone
石で作られた家=House made of stone
石の剣=Ishi-no-ken
神聖なローブ（上）=Sacred Robe (Top)
神聖なローブ（下）=Sacred Robe (Bottom)
種イモ=Seed potato
管=Cock
粘土=Clay
糞=Shit
焼いた肉(Dish)=Grilled Meat (Dish)
焼きキノコ=Grilled mushrooms
焼き野菜（料理）=Grilled vegetables (Dish)
爆発包=Detonator
牧畜の仕事をする場所（ブタ）=Place where cattle work (Pigs)
牧畜場（ブタ）=Cattle ranch (Pigs)
猟人の服（上）=Hunter's clothes (Top)
珊瑚（緑）=Coral (Green)
珊瑚（虹色）=Coral (Iridescent)
生肉=Raw meat
男の作業台の作り方がわかるレシピ=Recipe showing how to make a man's workbench.
男の作業台レシピ=Man's workbench recipe
発掘の仕事をする場所=Where the excavation work is done.
発掘場=Excavation site
白目=White eyes
白足袋=White floors
白身魚=Whitefish
皮袋（空）=Waterskin (Empty)
目=Look
目玉焼き(Dish)=Fried egg (Dish)
相手を殴って気絶させるための武器\n\n<color\=#33FF99>気絶5</color>=Weapons to beat and stun the opponent\n\n<color\=#33FF99>Stunned 5</color>
紐の水着（上）=String swimsuit (Top)
紐の露出水着（上）=Exposure swimsuit of string (Top)
紐の露出水着（下）=Exposure swimsuit of string (Bottom)
肉の作業台の作り方がわかるレシピ=Recipe showing how to make a meat workbench
肉の作業台レシピ=Meat Workbench Recipe
肉の盾=Meat shield
タマツボカズラ=Ballcreeper
ダディー=Daddy
タマネギ=Onion
タマネギの種=Onion seeds
ダルママシーン=Daruma Contraption
トウモロコシ=Corn
トウモロコシの種=Corn Seeds
トマトシチュー（料理）=Tomato stew (Dish)
トリ=Bird
ナイフ=Knife
ナイフを装備していません=Not equipped with a knife.
ポップコーン(Dish)=Popcorn (Dish)
ネコの衣装（下）=Cat costume (Bottom)
ネコの鼻=Cat's nose
ネズミ=Rat
ハチ=Bee
ハッパ=Leaf
ハートのワンド=Heart Wand
ハーフパンツ水着=Half pants swimsuit
バット=Bat
バトルアックス=Battle ax
バブルマシーン（右向き）=Bubble machine (Right)
バブルマシーン（左向き）=Bubble machine (Left)
パーティークラッカー=Party cracker
ビーチチェア（青）=Beach chair (Blue)
ビーチボール=Beach ball
マッサージ師の服=Massage Therapist Clothing
マッシュポテト(Dish)=Mashed Potato (Dish)
マミー[マミー]=Mommy [Mommy]
マンドラゴラ=Mandragora
マンドラゴラの中身をくり抜いて作った帽子\n=A hat made from the hollowed-out contents of a mandragora.
マンドラゴラハット=Mandragora Hut
フニフニとした食感が人気のお菓子\n\n<color\=#33FF99>Food100</color>=A popular confectionery with a fudgy texture\n\n<color\=#33FF99>Food100</color>
フライドポテト(Dish)=French fries (Dish)
プランターに植えるとジャガイモが育つ=Potatoes grow when planted in the planter
プランターに植えるとタマネギが育つ=Onions grow when planted in the planter
プランターに植えるとニンジンが育つ=Carrot grows when planted in a planter
プランターに植えるとニンニクが育つ=Garlic grows when planted in a planter
ヘッドクラブ=Head club
ボロボロな服=Tattered clothes
ボス=Boss
ホトペッパ=Hot pepper
レイカの水着（上）=Reika swimsuit (Top)
レイカの水着（下）=Reika swimsuit (Bottom)
ローストチキン(Dish)=Roasted Chicken (Dish)
ローストチキン（料理）=Roast Chicken (Dish)
ワンピース水着=One-piece swimsuit
ワニ=Crocodile
一つ設置する毎に\n襲撃者のレベルが2上がる=For every one installed\nraider's level increases by 2.
一つ設置する毎に\n襲撃者のレベルが5上がる=For every one installed\nraider's level increases by 5.
丈夫なツル\n=Sturdy Vine\n
丈夫な蜘蛛の巣=Sturdy spider web
丈夫な骨=Durable bone
三角頭巾=Triangular head
不思議な実（中）=Mysterious fruit (Medium)
不思議な実（大）=Mysterious Fruit (Large)
不思議な実（小）=Mysterious fruit (Small)
下半身を隠すために葉っぱで作ったもの=A clothing of sorts made with leaves for the lower body.
中型動物を飼育するための檻\n捕獲した動物とエサを入れておくと\n餌付け出来る（収容可能数2）=Cages for keeping medium-sized animals\nYou can put captured animals and food in it.\nCan be fed (Capacity 2)
乳バーガー(Dish)=Breast Burger (Dish)
乳焼き(Dish)=Nyuuyaki(Dish)
人体を吊り下げることができるフック=A hook that can hang the human body
使用すると即座に襲撃が起こる=If you use it, an attack will occur immediately
健康な土に植えるとジャガイモが育つ=Potatoes grow when planted in healthy soil.
健康な土に植えるとトウモロコシが育つ=Corn grows when planted in healthy soil.
健康な土に植えるとニンジンが育つ=Carrots grow better when planted in healthy soil.
健康ドリンク（料理）=Health drink (Dish)
処刑台（女）=Execution platform (Female)
動物からはぎ取った皮=Skin that has been removed from animals
原住民の精鋭マスク=Native elite mask
原始のノコギリ剣=Primitive sawtooth sword
可愛い作業台=Cute workbench
地底の女=Underground woman
吊り下げ型の照明=Hanging Light
地面に植えると木になる=It becomes a tree when planted on the ground
垂れ乳帽子=Pudgy hat
壺=Hu Vase
変異した蓮の花=Mutated lotus flower
夏の作業台=Summer workbench
大きめの管=Larger cock
大型動物を飼育するための檻\n捕獲した動物とエサを入れておくと\n餌付け出来る（収容可能数1）\n人）=Cages for keeping large animals\nYou can put captured animals and food in it.\nCan be fed (Capacity 1)\n(People)
実行=Execution
大自然の冠=The crown of nature
女サンタの服=Woman Santa's clothes
女主人公=Female hero
小さい生肉=Small raw meat
小ぶりな生の肉。そのまま食べると危険\n\n<color\=#33FF99>Food10</color>\n<color\=#FF0033>Food Poison30</color>=Small pieces of raw meat, dangerous to eat as is\n\n<color\=#33FF99>Food10</color>\n<color\=#FF0033>Food Poison30</color>
小さい魚を飾ることができる=Can be decorated with small fish.
巨大な棍棒=Giant Cudgel
巫女装束（上下）=Shrine maiden costume (Top&Bottom)
布のテント=Cloth tent
弱い日差しや雨くらいなら防げそう=It seems that it can be prevented if it is a weak sunlight or rain
布首飾り=Decorative
干し芋(Dish)=Dried sweet potato (Dish)
手術台=Operating table
拠点の目印になる旗\nマップにファストトラベルが追加される=Fast Travel is added to the flag map that is a landmark of the base
指巻き(Dish)=Finger Wrapping (Dish)
採集、農作の仕事で収穫したものを入れておく箱。=A box to keep the harvest from gathering and farming work.
揉めば揉むほど電気を発生させる珍しい筋肉=Unusual muscle that generates electricity the more it is squeezed
整形=Shaping
整形（仲間）=Shaping (Companion)
木で作られた弓=Bow made of wood
木で作られた針の床\n踏んだ敵にダメージを与える=Needle floor made of wood\nDamages enemies who step on it.
木のダミー人形=Wood dummy doll
木のテーブル=Wooden table
木のプランター=Wooden planter
木の剣=Wooden sword
木の器（空）=Wooden vessel (empty)
木の弓=Wooden bow
木の柵（大）=Wooden fence (large)
木の棘=Wooden
木の檻=Wooden cage
木の皿=Wooden plate
木の矢=Fletched Arrow
木の釣り竿=Wood fishing rod
木を組んで作った簡易的なベッド=A simple bed made of wood
木工することができる作業台=Workbench that can make woodworking
松明=Torchlight
枝の矢=Twig Arrow
染め物作業台=Dyeing workbench
棍棒=Cudgel
水を持ち運べる木でできた器\n=Vessels made of wood that can carry water\n
水を持ち運べる皮の袋\n=Leather bag to carry water\n
水上に設置できる=Can be installed on the water
水槽=Water tank
水着（チェック）=Swimsuit (check)
水着（貝殻）=Swimwear (shell)
洗う=Wash
浮き輪（フラミンゴ）=Float (Flamingo)
ケイゴのシャツ=Keigo's shirt
ケイゴのパンツ=Keigo's pants
レイカのサンダル=Reica's Sandals
レイカのリボン=Reika's Ribbon
木のテーブル（緑クロス）=Wooden table (Green cloth)
雨は降らなくなる=Rain will stop falling.
てるてる爺=Teru Teru Bozu
石の腰掛け=Stone seat
釣り餌として使える\n\n<color\=#33FF99>Food2</color>=Can be used as fishing bait\n\n<color\=#33FF99>Food2</color>

ヘビーアタック時、5メートル以内にある敵の死体を3体まで爆発させる。\n死体が爆発した時、自分を5%回復する\n\n<color\=#33FF99>Attack22</color>=During a heavy attack, explodes up to 3 enemy corpses within 5 meters.\nWhen the corpses explode, heals himself by 5%.\n\n<color\=#33FF99>Attack22</color>
生の肉。そのまま食べると危険\n\n<color\=#33FF99>Food30</color>\n<color\=#FF0033>Food Poison40</color>=Raw Meat: Dangerous to Eat Uncooked\n\n<color\=#33FF99>Food30</color>\n<color\=#FF0033>Food Poison40</color>
横たわる=lie down
ココナッツジュース(Dish)=Coconut juice (Dish)
食パン(Dish)=Bread(Dish)
ブール(Dish)=Buhl (Dish)
チーズ(Dish)=Cheese (Dish)
アイスクリーム(Dish)=Ice Cream (Dish)
出産場所の近くに置くと男の子が産まれる\n\n<color\=#33FF99>Food15</color>\n\n<color\=#00fa9a>Cooking Effects(During the raid)</color>=Placing a baby boy near the birthplace will give birth to a boy\n\n<color\=#33FF99>Food15</color>\n\n<color\=#00fa9a>Cooking Effects(During the raid)</color>
雄饅頭(Dish)=Male Manjuu(Dish)
出産場所の近くに置くと女の子が産まれる\n\n<color\=#33FF99>Food15</color>\n\n<color\=#00fa9a>Cooking Effects(During the raid)</color>=Loli is born when placed near the birthplace\n\n<color\=#33FF99>Food15</color>\n\n<color\=#00fa9a>Cooking Effects(During the raid)</color>
雌饅頭(Dish)=Female Manjuu(Dish)
飲むと成長値が上昇する\n成長値が18になると大人の姿になる\n（{{A}}専用）=Drinking increases growth value.\nWhen the growth value reaches 18, it becomes an adult\n(For {{A}} only)
HPを最大HPの50％分回復する\n\n<color\=#00fa9a>Cooking Effects(During the raid)</color>\n<color\=#00fa9a>Defence2</color>=Restores HP by 50% of maximum HP\n\n<color\=#00fa9a>Cooking Effects(During the raid)</color>\n<color\=#00fa9a>Defence2</color>
健康ドリンク(Dish)=Health drink (Dish)
トマトシチュー(Dish)=Tomato Stew (Dish)
えび天=Shrimp tempura
天ぷらうどん(Dish)=Tempura Udon (Dish)
豚カツサンド(Dish)=Pork cutlet sandwich (Dish)
えび天(Dish)=Shrimp tempura (Dish)
サンドウィッチ(Dish)=Sandwich (Dish)
サラダ(Dish)=Salad (Dish)
チャーシュー=Roasted pork fillet
ラーメン(Dish)=Ramen(Dish)
ニンニク=Garlic
ミートソースパスタ(Dish)=Pasta with meat sauce (Dish)
チーズ=Cheese
野菜ピザ(Dish)=Vegetable Pizza (Dish)
コロッケ(Dish)=Croquette (Dish)
グラタン(Dish)=Gratin (Dish)
焼いた小ぶりな肉\n\n<color\=#33FF99>Food10</color>\n\n<color\=#00fa9a>Cooking Effects(During the raid)</color>=Grilled small meat\n\n<color\=#33FF99>Food10</color>\n\n<color\=#00fa9a>Cooking Effects(During the raid)</color>
焼いた左腕（女）=Grilled left arm (Female)
焼いた左腕\n\n<color\=#33FF99>Food12</color>\n<color\=#FF0033>Moral-2</color>=Grilled left arm\n\n<color\=#33FF99>Food12</color>\n<color\=#FF0033>Moral-2</color>
焼いた左腕\n\n<color\=#33FF99>Food10</color>\n<color\=#FF0033>Moral-2</color>=Grilled left arm\n\n<color\=#33FF99>Food10</color>\n<color\=#FF0033>Moral-2</color>
焼いた左脚\n\n<color\=#33FF99>Food25</color>\n<color\=#FF0033>Moral-2</color>=Grilled left leg\n\n<color\=#33FF99>Food25</color>\n<color\=#FF0033>Moral-2</color>
焼いた左脚（女）=Grilled left leg (Female)
焼いた左腕（男）=Grilled left arm (Male)
焼いた右腕\n\n<color\=#33FF99>Food12</color>\n<color\=#FF0033>Moral-2</color>=Grilled right arm\n\n<color\=#33FF99>Food12</color>\n<color\=#FF0033>Moral-2</color>
焼いた右腕（男）=Grilled right arm (Male)
焼いた右脚\n\n<color\=#33FF99>Food25</color>\n<color\=#FF0033>Moral-2</color>=Grilled right leg\n\n<color\=#33FF99>Food25</color>\n<color\=#FF0033>Moral-2</color>
焼いた右脚（女）=Grilled right leg (Female)
焼き野菜(Dish)=Grilled Vegetables (Dish)




大きめの管[{{A}}]=Larger cock [{{A}}]
乳房=Breast
乳房（{{A}}）=Breast ({{A}})
乳房（{{A}}）[{{A}}]=Breast ({{A}}) [{{A}}]
処刑台（{{A}}）=The Execution Table ({{A}})
ボス{{A}}=Boss {{A}}
運搬中の{{B}}{{A}}（男）={{B}} {{A}} (Male) carried
運搬中の{{A}}（{{B}}）={{A}} ({{B}}) carried.
{{A}}（女）={{A}} (Female)
{{A}} has been spotted.={{A}} has been spotted
{{A}} is awake!={{A}} is awake!
{{A}}の前掛け={{A}} front cover
{{A}}の服（上）={{A}} Clothing (Top)
{{A}}の服（下）={{A}} Clothing (Bottom)
{{A}}ノースリーブ={{A}} Sleeveless
兄御{{A}}=Older brother {{A}}
左腕（{{A}}）=Left arm ({{A}})
焼いた左腕（{{A}}の子）=Roasted left arm ({{A}} child)
焼いた左脚（{{A}}の子）=Roasted left leg ({{A}} child)
左脚（{{A}}）=Left leg ({{A}})
焼いた左脚（{{A}}）=Roasted left leg ({{A}})
左脚（{{A}}{{B}}）=Left leg ({{A}} {{B}})
左腕（{{A}}{{B}}）=Left arm ({{A}} {{B}})
焼いた左腕（{{A}}）=Roasted left arm ({{A}})
焼いた右脚（{{A}}の子）=Roasted right leg ({{A}} child)
右脚（{{A}}）=Right leg ({{A}})
{{A}}箱={{A}} Box
{{A}}シャツ={{A}} Shirt
{{A}}ビキニ（上）={{A}} Bikini (Top)
{{A}}ビキニ（下）={{A}} Bikini (Bottom)
運搬中の{{A}}（男）={{A}} (Male) carried
{{A}}（男）[{{A}}]={{A}} (Male) [{{A}}]
乳房（{{A}}{{B}}）=Breast ({{A}} {{B}})
{{B}}（{{A}}）={{B}}（{{A}}）
{{A}}体の丸焼き(Dish)={{A}} whole body roast (Dish)
焼いた左脚（男）=Burnt left leg (Male)
右腕（{{A}}）=Right Arm ({{A}})
焼いた右腕（{{A}}の子）=Roasted right arm ({{A}} child)
焼いた右脚（男）=Burnt right leg (Male)
乳房（{{B}}{{A}}）=Breast ({{B}} {{A}})
{{A}}（{{B}}）={{A}}（{{B}}）
右腕（{{B}}{{A}}）=Right arm ({{B}} {{A}})
焼いた右腕（{{A}}）=Roasted Right Arm ({{A}})
右脚（{{B}}{{A}}）=Right leg ({{B}} {{A}})
焼いた右脚（{{A}}）=Roasted right leg ({{A}})
左脚（{{B}}{{A}}）=Left leg ({{B}} {{A}})
左腕（{{B}}{{A}}）=Left arm ({{B}} {{A}})
{{A}}（{{B}}）[{{B}}{{A}}]={{A}}（{{B}}）[{{B}}{{A}}]
運搬中の{{A}}（{{B}}）={{A}} ({{B}}) in transit
{{A}}ビキニ（上）={{A}} Bikini (Top)
{{A}}スカート={{A}} Skirt
左脚（{{A}}）[{{A}}]=Left leg ({{A}}) [{{A}}]
右脚（{{A}}）[{{A}}]=Right leg ({{A}}) [{{A}}]
{{B}}（女）[{{A}}]={{B}} (Female) [{{A}}]
運搬中の{{A}}（女）={{A}} (Female) carried
頭（{{A}}{{B}}）=Head ({{A}}{{B}})
{{A}}{{B}}[{{A}}{{B}}]={{A}}{{B}}[{{A}}{{B}}]
運搬中の{{A}}{{B}}={{A}}{{B}} in transit
ふつうの管[{{A}}]=Ordinary cock [{{A}}].
小さな管[{{B}}{{A}}]=Small cock [{{B}} {{A}}].
頭（{{A}}）=Head ({{A}})
頭（{{A}}）[{{A}}]=Head ({{A}}) [{{A}}].
{{A}}女をはりつけにする台=A platform to crucify {{A}} women
右腕（{{A}}）[{{A}}]=Right Arm ({{A}}) [{{A}}]
左腕（{{A}}）[{{A}}]=Left arm ({{A}}) [{{A}}]
